2323232323232323232323232323232323232323232323232323232323232323
2323232323232323232323232323232323232323232323232323232323232323
2323232323232323232323232323232323232323232323232323232323232323
2323232323232323232323232323232323232323232323232323232323232323
2323232323232323232323232323232323232323232323232323232323232323
2323232323232323232323232323232323232323232323232323232323232323
2323232323232323232323232323232323232323232323232323232323232323
2323232323232323232323232323232323232323232323232323232323232323
2323232323232323232323232323232323232323232323232323232323232323
2323232323232323232323232323232323232323234848232323232323232323
2323232323232323232323232323232323234848232323232323232323232323
2323232323232323232323232323234848232323232323234848232323232323
2323232323232323232323232323232323232323232323232323232323232323
2727272727272727272727272727272727270000000000000000272727272727
2525252525252525252525252525252525250000000000000000252525252525
2525252525252525252525252525252525251f1f1f1f1f1f1f1f252525252525
2d2e2e2e2e2e2e2e2e2e2e2e2e2e2e2e2e2e2e2e2e2e2e2e2e2e2e2e2e2e2f30
002e2e2e2e2e2e2e2e2e2e2e2e2e2e2e2e2e2e2e2e2e2e2e2e2e2f2e2e2e2f00
0000000006000000000001000000000002000000000003000000000007000000
0000000000000000000000000000000000000000000000000000000000000000
0000000000000000000000000000000000000000000000000000000000000000
0000000000000000000000000000000000000000000000000000000000000000
002e2f2f2f2f2f2f2f2e2e2e2e2e2e2e2e2e2e2e2e2e2e2e2e2e2e2f2e2e2f00
002e2f2f2f2f2f2e2f2f2f2f2f2f2f2f2f2f2f2f2f2f2f2f2f2f2f2f2f2f2f00
