2323232323232323232323232323232323232323232323232323232323232323
2323232323232323232323232323232323232323232323232323232323232323
2323232323232323232323232323232323232323232323232323232323232323
2323232323232323232323232323484848234848484823232323232323232323
2323232323232323232323232323232323232323232323232323232323232323
2323232323232323232323484848232323232323232323232323232323232323
2323232323232323232323232323234848482323232323232323232323232323
2323232323232323232323232323232323232348484823232323232323232323
2323232323232323232323232323232323232323232323232323232323232323
23232323232323232323232323232323232348481f1f1f232323232323232323
2323232323232323232323232323232323484848481f1f232323232323232323
2323232323232323232323234848481f48484848481f1f232323232323232323
2626262626262626262626262626262626262626262626262626262626262626
2222222222222222222222222222222222222222222222222222222222222222
2222222222222222222222222222222222222222222222222222222222222222
2222222222222222222222222222222222222222222222222222222222222222
