2424242424242424242424242424242424242424242424242424242424242424
2424242424242424242424242424242424242424242424242424242424242424
2424242424242424242424242424242424242424242424242424242424242424
2424242424242424242424242424242424242424242424242424242424242424
2424242424242424242424242424242424242424242424242424242424242424
2424242424242424242424242424242424242424454524242424242424242424
2424242424242424242424242424242424454524454524242424242424242424
2424242424242424242424242424454524454524454524242424242424242424
2424242424242424242424454524454524454524454524242424242424242424
2424242424242424454524454524454524454524454524242424242424242424
242424242424454545451f45451f45451f45451f45451f1f2424242424242424
2424242445454545454545454545454545454545454545452424242424242424
4141414141414141414141414141414141414141414141414141414141414141
4a4a4a4a4a4a4a4a4a4a4a4a4a4a4a4a4a4a4a4a4a4a4a4a4a4a4a4a4a4a4a4a
4a4a4a4a4a4a4a4a4a4a4a4a4a4a4a4a4a4a4a4a4a4a4a4a4a4a4a4a4a4a4a4a
4a4a4a4a4a4a4a4a4a4a4a4a4a4a4a4a4a4a4a4a4a4a4a4a4a4a4a4a4a4a4a4a
