232323232323232323232323232323232323232323232323232315232323232323232323232323232323232323232323232323181923232323232323232323232323232323232323232323232317232323232323232323232323232323232323232323232323232323162323232323232323232323232323
232323232323232323232323232323232323232323232326262626262626232323232323232323232323232323232323262626231623232323232323232323232323232323232323232323262626262323232323232323232323232323232323232323232323232626262626232323232323232323232323
262623232323232323232323232323232323232626262626262626262626262626232323232323232323232323262626262626262623232323232323232323232323232323232323232626262626262626232323232626262626232323232323232323232326262626262626262626232323232323232323
212626262626262626262626262626262626262621212121212121212121212126262626262626262626262626262121212121212626262626262626262626262626262626262626262121212121212126262626262626262626262626262626262626262626262621212121212626262626262626262626
212121212121212121212121212126262626262626262121212121212121212126262626262621212121212121212121212121212626262626262121212121212121212121212626212121212121212126262626262621212121212121262626212126262121212121212121212121212121212121212121
212121212121212121212121212121212121212121212121212121212121212121212121212121212121212121212121212121212121212121212121212121212121212121212121212121212121212121212121212121212121212121212121212121212121212121212121212121212121212121212121
262626262626262626262121212121212121212121262626262121212121262626262121212121212121212121212121212121212121212121212121212121212121212121212121212121212121212121212121212121212121212121212121212121212121212121212121212121212121212121212121
262626262626262626262626262626262626262626262626262626262626262626262626262626262626262626262626262626262626262626262626262626262626262626262626262626262626262626262626262626262626262626262626262626262626262626262626262626262626262626262626
424242424242424242424242424242424242424242424242424242424242424242424242424242424242424242424242424242424242424242424242424242424242424242424242424242424242424242424242424242424242424242424242424242424242424242422525252525252525252525252525
424242424242424242424225254242252542424242424242424242424242424242252525252525252525252525252525252542424225252542422525252542422525254242252525424225252525254242424242252525254242424242424242424242424242424242422525252525252525252525252525
252525252525252525424225254242252542422525254242424225252525424242252525252525252525252525252525252542424225252542422525252542422525254242252525424225252525254242424242252525254242422525252525252525252525254242422525252525252525252525252525
2525252525252525254242252542424242424225252542424242252525254242422525424242424242252525424242424242424242424242424242252542424242424242422525254242424242424242424242422525252542424225252525464725252525252542424242424242424242424242422a2a2a
252525252525252525424225252525424242424242424242424225252525424242424242424242424225252525424242424242424242424242424225254242424242424242424225252525252525252525252542424242424242422525252544452525252525254242424242424242424242424242424242
4242424242424242424242252525252542424242424242424242424242424242424242424242424242252525252525424242424242424242424242252542424242424242424242252525252525252525252525424242424242424242424242424242424242424242424242424242424242424242422a2a2a
4242424242424242424242252525252525252525252525252525254242424242424242424242424242252525254a4b25252525252525252542424242424242424242424242424242424242424242424242424242424242424242424242424242424242424242424242424242424242424242424242424242
4242424242424242424242252525252525252525252525252525254242424242424242424242424242252525254849252525252525252525424242424242424242424242424242424242424242424242424242424242424242424242424242424242424242424242424242424242424242424242422a2a2a
