232323232323232323232323232323232323232323232323232323232323232323232323232323232323232323232323232323232323232323232323232323232323232323232323232323232323232323232323232323232323232323232323232323232323232323232323232323232323232323232323
232323232323232323232323232323232323232323232318192323232323232323232323232323232323232323232323232323232323232323232323232323232323232323232323232323232323232323232323232323232323232323232323232323232323232323232323232323232323232323232323
2323232323232323232323232323232323232323232323231623232323232323232323232323232323232323232323232323232323231a1b23232323232323232823282328232823232323232323232323232323232323232323232323232323232323232323232323232323181923231a1b232323232323
232318192323232323232323232323232323232327272727272727232323232323232323232323232323232323232323232323232323231623232323232323232828282828282823232323232323272727272727272727272727232323232323232323232323232323232323231623232317232323232323
232323172323232323232727272723232323232325252525252525232323232327272727272727272323232323232325252323232327272727272723232323232828282828022823232323232121212121212121212121212121212121232323232323232323232323232121212121212121232323232321
272727272727272727272727272727272727272727272727272727272727272727272727272727272727272727272727272727272727272727272727272727272727272727272727272727272727272727272727272727272727272727272727272727272727272727272727272727272727272727272727
434343434343434343434343434343434343434343434343434343434343434343434343434343434343434343434343434343434343434343434343434343434343434343434343434343434343434343434343434343434343434343434343434343434343434343434343434343434343434343434343
43434343432121212121212121212121214321212121212121212121434343432121212121212121212121212121434321212121212121212121212121212121212121212143434343432121212121212121212121212121434343434343434321212121212121212121212143212121212143432a2a2a2a
434343434321212121212121212121212143212121212121212121214343434321212121212121212107212121214343212121212121212121212121212121212121212121434343434321212121212121212121212121212121212121214343212121212121212121212121432121212121214343434343
2121212121212121212121212121212121432121212121212121212143434343212121212143434343434321212121432121212121432121212121212121212121212121214343434343212121212121434343432121212121212121212121432121212121434343434343434321212121212121432a2a2a
212121212121072143434343432121212143212121214321212121212121212121212143434343432121212121212143212121214343212121212121434321212121214343434343434321212107214343434343434343434343432121212121212121212143212121212143212121212121212121252525
21212121212121212143434343434343434321212121432121212121212121212121214321212143212121212121212121212143434343434321212143432121212121212121212143432121212121212121212121212121212143212121212121212121434321212121214321212121432121212121252a
434343434321212121212121212121212121212121434321212143434343434343434343212121432121212121212121212121212121212143212121434321212121212121212121434321212121212121212121212121212121432121212121212121214343214343434343212121214343212121212525
434343434321212121212121212121212121212121434321212143434343434343434343212121434343434321212121212121212121212143212121434343434343212121212143434321212143432121212121434343434343432121212121212121212121212121434343212121214343432121212525
434343434321212121212121212121214343434343434321212121212121212121212121212121212121214321212121212121212121212143212121434321212121212121212121212121212143432121212121212121212121432121212121212121212121212121212121212121214321212121212121
434343434321212121212121212121214343434343434321212121212121212121212121212121212121214343434343434343434343434343212121434321212121212121212121212121212143432121212121212121212121432121214343432121212121212121212121212121214321212121212121
