232323232323232323232323232323232323232323232323232323232323232323232323232323232323232323232323232323232323232323232323232323232323232323232323232323232323232323232323232323232323232323232323232323232323232323232323232323232323232323232323
232323232323232323232323232323232323232323232323232323232323232323232323232323232323232323232323232323212121212123232323232323232323232323232323232323232323232323232325232323232323232323232323232323232323232323232323232323232323232323232323
232323232323232323232323232323232323232323232323232323232323232323232323232323232323232323232323232321212121212123232323232323232323232323232323232323232323232324242424242424242323232323232323232323232323232323232323232323232323232323232323
232323232323232323232424242424242424242424242424242323232323232323232323232323232323232121212121212121212121212123232323232323232323232323232323232323232323232324242424242424242323232323232323232323232323232323242424242424232323232323232323
232323232323232323232424242324232423242324242424242323232323232323232323232323232323232121212121212121212121212123232323232323232323232323232323232323232323232324232424242424242424242424242323232323232323232323242423242324232323232323232323
2323232323232323232324242424242424242424242424242423232323231819232323232323232323232321232123212321232123212321232318192323232323232323232323232323231a1b23232324242424242323242424242424242323232323232323232323242424242424232323232323232323
232323232323232323232424242323232323232324242425242323232323231523232323232323232323232125212121212121212121212123232316232323232323232323232323232323231623232324252424242323242323242323242323232323232323232323242424242524232323232323232323
4242424242424242424242424242424242424222222222222242424242424242424242424242424242424242424242424242424242424242424242424242424242222222222222222222224242424242424242424242424242424242424242424242424242424242424242424242424242424242422a2a2a
424242424242424242424242424242424242422222222222224242424242424222224242424242424242424242424242222222222222224242222222222222424222222222220722222222424242424242424242424242424222222242424242222242424242424242424242424242424242424242424242
424242424242424242424242424242424242424242424242424242424242424222224242424242424242424242424242222222222222224242222222222222424242424242424242424242424222222222224242424242424222222242424242222242424232222224232222224242424242424242422a2a2a
22222222222222222222424222222222222242424242424242422222424242422222424242424242424242424242424222222222424242424242424242424242424242424242424242424242422222222222424242424242424242424242424242424242423222222423222222424242424242424242424242
22222222222222222222424222222222222242424242424242422222224242424242424242424242424242424242424242424242424242424222222242424242424242424242424242222242424242424242424242424242424242424242424242424242423222222423223223224242424242424242422a2a2a
222222222222222222224242222222222222424242424242424222222222222242424222222222222222222222224242424242424242424242220722424242424242424242424242422222424222222242422222424222223223224242424242424242222232232232232242424242222222222222222222222222
4242424242424242424242424242424242424242424242424242424222222222424242222222224c4c22222222224242424242422222224242222222424242424242424242424242422222424222222242422222424222223223224242424242424242222232242424242424242222222222222222222222222
4242424242424242424242424242424242424242424242424242424242222222424242424242424242424242424242424242424222222242424242424242424242424242424242424242424242424242222242422222224a4b22222222222222224242424242424242424242424242424242424242424242
424242424242424242424242424242424242424242424242424242424242222242424242424242424242424242424242424242422222224242424242424242424242424242424242424242424242424222224242222222484922222222222222224242424242424242424242424242424242424242424242
