222222222222222222222222222222222222222222222222222222222222222222222222222222222222222222222222222222222222222222222222222222222222222222222222222222222222222222222222222222222222222222222222222222222222222222222222222222222222222222222222
222222222222222222222222222222222222222222222222222222222222222222222222222222222222222222222222222222222222222222222222222222222222222222222222222222222222222222222222222222222222222222222222222222222222222222222222222222222222222222222222
222222222222222222222222222222222222222222222222222222222222222828222222222222222222222222222224242222222222222222222222222228282228282228282222222222222222282822282822222222222222222222222424222424222424222222222222222222222222222828222222
222222242224242224222222222222222222222222222222222222282828222828222222222222222222222222222224242222222222222222222222222228282828282828282222222222222222282828282822222222222222222222222424242424242424222222222222222222222222222828222222
222222242424242424222222222222222222222222222222222228282828282828222222222222222222222222222224242222222222222222222222222228282828282828282222222222222222282828282822222222222222222222222424242424242424222222222222222222222222222828222222
222222242424242424222222222222222222222222222222222228282828282828222222222222222222222222222224242222222222222222222222222228282828282828282222222222222222282828282822222222222222222222222424242424242424222222222222222222222222222828222222
262626262626262626262626262626262626262626262626262626262626262626262626262626262626262626262626262626262626262626262626262626262626262626262626262626262626262626262626262626262626262626262626262626262626262626262626262626262626262626262626
424242424242424242424242424221212121212121212121212121212121212121212121212121212142424221212121212121212121212121212121212121212142422121212121212121212121212121212121210721212121212121212142424242424242212121212121212121212121212121212121
424242424242424242424242424221212121212121212121212121212121212121212121212121212142424221212121212121212121212121212121212121212142422121212121212121212142424242424242424242424242422121212142424242212121212121212121212121212121212121212121
424242424242424242424242424221212121212121422121212121424242424242424242424242424242424221212121212142424242424242424221212107212142422121212121212121212121212121212121212121424242422121212142424242212121212121212121212142424242424242424242
2121212121212121212121424242212107212121214221212121212121212121212121212121212142422121212121212121212121212121214242212121212142424242422121212121212121212121212121212121214242424221212121424242422121212121212121212121424242422a2a2a2a2a2a
212121212121212121212142424242212121212121422121212121212121212121212121212121214242212121212121212121212121212121424221212121212142424242212121212121424242212121214242424242424242422121212121424242212121424242424242424242424242424242424242
4242424242422121212121424242422121212121214242212121212121212121212121212121212142422121212121214242424242424242424242212121212121214242422121212121424242422121212142424242424242424242422121214242422121214242424242424242424242422a2a2a2a2a2a
424242424242422121212121212121212121212121424242212121212121214242424242424242424242212121212121212121212142422121212121212121212121212121212121212121212142212121212121212121212121214242212121212121212121212121212121212121212142424242424242
4242424242424242212121212121212121212121214242424221212121212121212121212121212121212121212121212121212121424221212121212121212121212121212121212121212121422121212121212121212121212142422121212121212121212121212121212121212121422a2a2a2a2a2a
424242424242424221212121212121212121212121424242424221212121212121212121212121212121212121212121212121212142422121212121212121212121212121212121212121212142212121212121212121212121214242212121212121212121212121212121212121212142424242424242
