2323232323232323232323232323232323232323232323232323232323232323232323232323232323232323232323232323232323232323231c1d2323232323232323232323231c1d2323232323232323232323232323232323232323232323232323232323232323232323232323232323232323232323
2323231c1d232323232323232323231c1d23232323232323232323232328232823232323232323232323232323232323232323232323232323232323232323232322232323232323232323232323232323232323232323232323232323232323232323232323232323232323232323232323232323232323
2323232323232323232323232323232323232323232323232323232323282828232323231c1d23232323232323232323232324232323232323232323232323232222222323232323232323232323232323242424242424242424242424232323232323232323232323232323232323232323232323232323
232323232323232323232323232323232323232323232323232323232328282823232323232323232323232323232323232424242323232323232323232323232222222323232323232323232323232324242424242424242424242424232323232323232323232323232323232323232323232323232323
23232323232323232323232323232323232323232323232328232823232828282323232323232323232323232323232323242424232323232323231c1d2323232222222323232323232323232323232222222222222222222224242424232323232323232323232424242424242424242424232323232323
232323232323232328232823282328232823232323232323282828282828282823232323232323232328282828282828282824242323232323232323232322232222222323232323232323232323232222222222222222222224242424232323232323232323232424432424242424432424232323232323
232323232323232328282828282828282823232323232323282828282828282823232323232323232328432828432828432824242323232323232323232222222222222323232323232323232322222222222222222222222224242424232323232323232323232424242424242424242424232323232323
232323232323232328282828284328282823232323232323282828282828432823232323232323232328282828282828282824242323232323232323232222222243222323232323232323232322222222222222222222432224244324232323232323232323232424242424432424242424232323232323
434343434343434343434343434343434343434343434343434343434343434343434343434343434343434343434343434343434343434343434343434343434343434343434343434343434343434343434343434343434343434343434343434343434343434343434343434343434343434343434343
434343434343434343434324242424242424242424242424242424242424242424242424432424244324242443242424432424244324242443434343242443432424242424242424242424242443242424432424244343434343434343434343434343434343432424242424434343242424244324242424
2424242424242424242424242424242424242424242424242424242424242424242424244324242443242424432424244324242443242424434343432424434324242424242424242424242424432424244324242424242424242424434324242424242424244324242424244324244324242443242a2a2a
242424242424242424242424244343434343434343434343434343434343434343434343434343434343434343434343434343434343434343434343434343432424434343434343434343434343434343432424242424242424242443432424242424242424434343434343432424434343434324242424
2424242424242424242424242443434343434324242424242424242424242424072424244343434343434343434343434343432407242424242424242424242424244343434343434324244343432424244343434343434343434343434324244343434343434343434324242424244324242443242a2a2a
434343434343434343434324242424242424242424244343434343434324242424242424434343434343434343434343434343242424242424242424242424242424434343434343432424434343240724432424242424242424242443434343434343434343434343432424242424432424244324242424
434343434343434343434343434343434343434343434343434343434343434343434343434343434343434343434343434343434343434343434343434343434343434343434343434343434343434343434343434343434343434343434343434343434343434343434343434343434343434343434343
434343434343434343434343434343434343434343434343434343434343434343434343434343434343434343434343434343434343434343434343434343434343434343434343434343434343434343434343434343434343434343434343434343434343434343434343434343434343434343434343
