232323232323232323232323232323232323232323232323232323232323232323232323232323232323232323232323232323232323232323232323232323232323232323232323232323232323232323232323232323232323232323232323232323232323232323232323232323232323232323232323
232323232323232323232323232323232323232323232323232323232323232323232323232323232323232323232323232323232323232323232323232323232323232323232323232323232323232323232323232323232323232323232323232323232323232323232323232323232323232323232323
232323232323232323232323232323232323232323232323232323232323232828232323232323232323232323232324242323232323232323232323232328282328282328282323232323232323282823282823232323232323232323232424232424232424232323232323232323232323232828232323
232323242324242324232323232323232323232323232323232323282828232828232323232323232323232323232324242323232323232323232323232328282828282828282323232323232323282828282823232323232323232323232424242424242424232323232323232323232323232828232323
232323242424242424232323232323232323232323232323232328282828282828232323232323232323232323232324242323232323232323232323232328282828282828282323232323232323282828282823232323232323232323232424242424242424232323232323232323232323232828232323
232323242424242424232323232323232323232323232323232328282828282828232323232323232323232323232324242323232323232323232323232328282828282828282323232323232323282828282823232323232323232323232424242424242424232323232323232323232323232828232323
262626262626262626262626262626262626262626262626262626262626262626262626262626262626262626262626262626262626262626262626262626262626262626262626262626262626262626262626262626262626262626262626262626262626262626262626262626262626262626262626
424242424242424242424242424242424242424242424242424242424242424242424242424242424242424242424242424242424242424242424242424242424242424242424242424242424242424242424242424242424242424242424242424242424242424242424242424242424242424242424242
424242424242424242424242424242424242424242424242424242424242424242424242424242424242424242424242424242424242424242424242424242424242424242424242424242424242424242424242424242424242424242424242424242424242424242424242424242424242424242424242
424242424242424242424242424221212121212121212121212121212121212121212121212121212142424221212121212142424242424242424221212107212142422121212121212121212121212121212121210721422121212121212142424242212121212121212121212121212121212121212121
2121212121212121212121424242212107212121214221212121214242424242424242424242424242422121212121212121212121212121212121212121212142424242422121212121212121212121212121212121214221212142212121424242422121212121212121212121212121212a2a2a2a2a2a
212121212121212121212142424242212121212121422121212121424242424242424242424242424242212121212121212121212121212121212121212121212142424242212121212121424242212121214242424242422121214221212121424242212121424242424242424242212121212121212121
4242424242422121212121424242422121212121214242212121212121212121212121212121212142422121212121214242424242424242424242212121212121214242422121212121424242422121212142424242424221212142422121214242422121214242424242424242424242422a2a2a2a2a2a
424242424242422121212121212121212121212121424242212121212121212121212121212121212121212121212121212121212142422121212121212121212121212121212121212121212142212121212121212121212121214242212121212121212121212121212121212121212142424242424242
424242424242424242424242424242424242424242424242424242424242424242424242424242424242424242424242424242424242424242424242424242424242424242424242424242424242424242424242424242424242424242424242424242424242424242424242424242424242424242424242
424242424242424242424242424242424242424242424242424242424242424242424242424242424242424242424242424242424242424242424242424242424242424242424242424242424242424242424242424242424242424242424242424242424242424242424242424242424242424242424242
