232323232323232323232323232323232323232323232323232323232323232323252323232323232323232323232323232323232323232323232323232323232325252325252525252525232323232323232323232323232323232323232323252525252323232323232323232323232323232323232323
232323232323232323232323232323232323232525232323232323232323232325252323232323232323232323232323232323232323232323232323232323232325252525252525252525232323232323232323232323232323232323232323252525252325252323232323252523232323232323232323
232323232323232323232323232325252323232525232323232323232323232325252323232323232323232323232323232323232323232323232323232323252525252525252525252525232323232323232323232323232323232323232323252525252325252323232325252523232323232323232323
232323232323252525252323232325252525252525232323232323232323232325252323232323232323232323232323232323232323232323232323232323252525252525252525252525232323232323232323232323232323232323232323252525252325252323232525252523232323232323232323
232323232323252525252525252525252525252525232323232323232323232325252525252525252525252323232323232323232323232323232323232323252525252525252525252525232323232323232323232323232323232323232325252525252325252525252525252523232323232323232323
232323232323252525252525252525252525252525232323232323232323232325252525252525252525252323232323232323232323232323232323232323252525252525252525252525232323232323232323232323232323232323232325252525252525252525252525252523232323232323232323
252525252525252525252525252525252525252525252525252525252525252525252525252525252525252525252525252525252525252525252525252525252525252525252525252525252525252525252525252525252525252525252525252525252525252525252525252525252525252525252525
414141414141414141414141414141414141414141414141414141414141414141414141414141414141414141414141414141414141414141414141414141414141414141414141414141414141414141414141414141414141414141414141414141414141414141414141414141414141414141414141
414141414141414141414141414141414141414141414141414141414141414141414141414141414141414141414141414141414141414141414141414141414141414141414141414141414141414141414141414141414141414141414141414141414141414141414141414141414141414141414141
414141414141412121212121212121212121212121212121212121212121212121212121072121212121212121212121414121212121212121212121212121212121212121214121212107212141414121212121212121212121212121212121212121212121212121212121214121212121212a2a2a2a2a
212121212121212121212121212121212121212121212121212121212121212121212121212121212121414141414141414121212121212121212121212121212121212121214141412121212141414121212121212121212121212141414141414121212121212121212121214121212121212121212121
212121212121212121212121414141414141414141414141414141414141212141412121214121212121212121212121212121212121414121212121212121212121212121214141412121212141414121212121212121212121212121072121214121212121212121212121214121212121212a2a2a2a2a
414141414141412121212121212121212121212121212121212121212121212121212121214121212121212121212121212121212121414121212121414141414141212121214141412121212141414121212141414141414121212121212121214121214141414141414141414121212121212121212121
414141414141412121212121212121212121212121212121212121212121212121212121214121212121212141414141414141414141414121212121414141414141212121212121212121212121212121212141412121212121212141414141214121212121212121212121212121212121212a2a2a2a2a
414141414141414141414141414141414141414141414141414141414141414141414141414141414141414141414141414141414141414141414141414141414141414141414141414141414141414141414141414141414141414141414141414141414141414141414141414141414141414141414141
414141414141414141414141414141414141414141414141414141414141414141414141414141414141414141414141414141414141414141414141414141414141414141414141414141414141414141414141414141414141414141414141414141414141414141414141414141414141414141414141
