232323232323232323232323232323232323232323232323232323232323232323232323232323232323232323232323232323232323232323232323232323232323232323232323232323232323232323232323232323232323232323232323232323232323232323232323232323232323232323232323
2323232323232323232323232323232323242424232323232323231c1d2323232323232323232323232323232323232323232323232323231c1d2323232323232323232323232323232323232323232323232323232323232323232323232323232323232323232323232323232323232324232423232323
232323232323232323232323232323232324242423232323232323232323232323232323232323232323232323232323232323232323232323232323232323232324242423232323252525252523232323232323232023232323232323232323232323232323232323232323202323232324242423232323
232323232323232323242424242424242424242423232323232323232323232323232323232323232323242424242424232323232323232323232323232323232324242423232323252525252523232323232323232323232323232323232424242424242424242323232323232323232324242423232323
23232323232323232324242323242323242323242323232323232323232323232323232323232424242424240b0c0d24232323232323232323232323232323232324242421212121212121212123232323232323232323232323232323232424240e0f102424242323232323232323232324242423232323
23232323232323232324242323242323242323242323232323232323232323232323232323232423242423242b2c2d24232323232323232323232323232323232324242421212321212123212123232323232323232323232323232323232424242e2f302424242323232323232323232324242423232323
232323232323232323242424242424242424242423232323232323232323232323232323232324242424242424242424232323232323232323232323232323232324242421212121212121212123232323232323232323232323232323232424242424242424242323232323232323232324242423232323
424242424242424242424242424242424242424242424242424242424242424242424242424242424242424242424242424242424242424242424242424242424242424242424242424242424242424242424242424242424242424242424242424242424242424242424242424242424242424242424242
424242424242424242424242424242424242424242424242424242424242424242424242424242424242424242424242424242424242424242424242424242424242424242424242424242424242424242424242424242424242424242424242424242424242424242424242424242424242424242424242
222222222242424242424242424242424242424242424242424242424242222222222222222222224242424242424242424242422222222222222222222222222222222222222222222222222222222222224242424242222222222222222222222222222222222222222222224242424242424222222222
2222222222222222222222222222222222222222222222222222222222222222222222222222222222222222222222222222224222222222222222222222222222222222222222222222222222222222222222424242422222222222222222222222222222222222222222222242424242424242222a2a2a
4242424242222222222222222222222222222222222222222222222222222222424222224242222242424242424242424222224222222242422222424242424242424242424242424242424242424242422222224242422222424242424242424242424242424242424242222222424242424242222a2a2a
4242424242222222424242424242422222424242424242424242222242424242424222224242222222222222222222224242424222224242422222222222222222222222222222222222222222424242422222222222222222222222222222222222222222222222224242222222222222222222222a2a2a
424242424222222222222222222222222222222222222222222222222222222222222222224242422222222222222222222222222222424242222222222222222222222222222222222222222242424242222222222222222222222222222222222222222222222222424222222222222222222222222222
424242424242424242424242424242424242424242424242424242424242424242424242424242424242424242424242424242424242424242424242424242424242424242424242424242424242424242424242424242424242424242424242424242424242424242424242424242424242424242424242
424242424242424242424242424242424242424242424242424242424242424242424242424242424242424242424242424242424242424242424242424242424242424242424242424242424242424242424242424242424242424242424242424242424242424242424242424242424242424242424242
